# E # # # # # # #
# - # # # # - - -
# - - - - # - # G
# # # # - # - - #
# # - # - D # - -
# # # # # - # # -
# - - - - - # - -
K - # # # - # - #
# # - - - - - - #
# # - # # # # # #
# # C # # # # # #