# E # # # # # # #
# - # # # # - - -
# - - - - # - # -
# # # # - # - - #
# # # # - D # - -
# # # # # - # # -
# - - - - - # - -
K - # # # - # - #
# # - - - - - - #
# # - # # # # # #
# # C # # # # # #