# # # # # # - - -
# P - - - - - # -
E # # # - # # T -
D # G K - # # # #
- # # # # P - - C
- # # # # # # # -
- # - - - - # - -
- # - # # - # G #
- # - # # - # - #
- # # - - - - - #
- - - - # # # # #