# # # # # # # # #
# T G # G - - - K
# P # # P # - # K
# # # # # - - - #
E D - - - D # - -
# # # # # # # # -
# - - - - - # - -
# - # # # - # - #
# - - - # - - - #
# # - # # # T # #
# C - # # # # # #