# # # # # # # # #
# # # # # # - - K
# # # # # # - # K
# # # # # - - - #
E D - - - D # - -
# # # # # # # # -
# - - - - - # - -
# - # # # - # - #
# - - - # - - - #
# # - # # # - # #
# C - # # # # # #