# # # # # # - - -
# P - - - - - # -
E # # # - # # T -
D # G K - # # # #
- # # # # P - - C
- # # # # # # # -
- # T T - - # - -
- # T # # - # G #
- # T # # - # - #
- # # - - - - - #
- - - - # # # # #